11111111111111111111111111111
1P0C00000000000000000C0000C01
1000000M000000000M00000000001
11100000000000M00000100M00001
100000000M00M1111111100000001
10000000000000000000111110001
10000000000000000000100000001
111111111111100000001000M0001
10000000000000000000100000001
1000000M010000M000001M0000001
100000C0010000000000100000001
10000000010000000000100011111
1000M000010000000000100000001
1C0000000100C00000001000E0001
11111111111111111111111111111