1111111111111111111111111111
1P0C00000000000000000C0000C1
1000000000000000000000000001
1000000000000000000000000001
1000000000000000000000000001
10000C000000000000000000E001
1111111111111111111111111111