1111111111111111111111111111
1P0C00000000000000000C0000C1
10000000000000000M0000000001
1000000000000000000010000001
100000000000M000000010000001
10000C000000000000001000E001
1111111111111111111111111111