1111111111111111111111111111
1P0C00000000000000000C0000C1
1000000M000000000M0000000001
10000000000000M00000100M0001
100000000M00M000000010000001
10000C00000000M000001000E001
1111111111111111111111111111